3 4 4 4 4 4 4 4 4 4 4 4 4 4 4 4 4 4 4 4 4 4 4 4 4 4 4 4 4 4 4 4 4 4 4 4 4 4 4 4 4 4 4 4 4 4 4 4 4 4 4 4 4 4 4 4 4 4 4 4 4 4 4 4 4 4 4 4 4 5 
3 4 4 4 4 4 4 4 4 4 4 4 4 4 4 4 4 4 4 4 4 4 4 4 4 4 4 4 4 4 4 4 4 4 4 4 4 4 4 4 4 4 4 4 4 4 4 4 4 4 4 4 4 4 4 4 4 4 4 4 4 4 4 4 4 4 4 4 4 4 
3 4 4 4 4 4 4 4 4 4 4 4 4 4 4 4 4 4 4 4 4 4 4 4 4 4 4 4 4 4 4 4 4 4 4 4 4 4 4 4 4 4 4 4 4 4 4 4 4 4 4 4 4 4 4 4 4 4 4 4 4 4 4 4 4 4 4 4 4 5 
3 4 4 4 4 4 4 4 4 4 4 4 4 4 4 4 4 4 4 4 4 4 4 4 4 4 4 4 4 4 4 4 4 4 4 4 4 4 4 4 4 4 4 4 4 4 4 4 4 4 4 4 4 4 4 4 4 4 4 4 4 4 4 4 4 4 4 4 4 5 
3 4 4 4 4 4 4 4 4 4 4 4 4 4 4 4 4 4 4 4 4 4 4 4 4 4 4 4 4 4 4 4 4 4 4 4 4 4 4 4 4 4 4 4 4 4 4 4 4 4 4 4 4 4 4 4 4 4 4 4 4 4 4 4 4 4 4 4 4 5 
3 4 4 4 4 4 4 4 4 4 48 48 4 4 4 4 4 4 4 4 4 4 4 4 4 4 4 4 4 4 4 4 4 4 4 4 4 4 4 4 4 4 4 4 4 4 4 4 4 4 4 4 4 4 4 4 4 4 4 4 4 4 4 4 4 4 4 4 4 5 
3 43 48 41 4 4 43 48 41 4 48 48 4 43 48 41 4 4 4 4 4 43 48 41 4 4 4 4 43 48 41 4 4 4 4 4 43 48 41 4 4 4 4 4 43 48 41 4 4 4 4 43 48 41 4 4 4 4 4 43 48 41 4 4 4 43 48 41 4 5 
3 47 48 60 4 4 47 48 60 4 4 4 4 47 48 60 4 4 4 4 4 47 48 44 4 4 4 4 47 48 44 4 4 4 4 4 47 48 44 4 4 4 4 4 47 48 44 4 4 4 4 47 48 44 4 4 4 4 4 47 48 44 4 4 4 47 48 44 4 5 
3 62 48 63 64 65 66 48 63 64 64 65 65 66 48 63 64 64 64 65 64 66 48 63 65 64 65 64 66 48 63 65 64 65 64 65 66 48 63 65 64 65 64 65 66 48 63 64 65 64 65 66 48 63 64 65 64 65 64 66 48 63 64 65 64 66 48 44 4 5 
3 62 48 48 48 48 48 48 48 48 48 48 48 48 48 48 48 48 48 48 48 48 48 48 48 48 48 48 48 48 48 48 48 48 48 48 48 48 48 48 48 48 48 48 48 48 48 48 48 48 48 48 48 48 48 48 48 48 48 48 48 48 48 48 48 48 48 44 4 5 
3 47 48 25 26 26 26 27 26 27 26 27 27 26 27 27 27 26 27 27 27 26 26 26 27 26 27 26 27 26 27 26 27 26 27 26 27 26 27 26 27 26 27 26 27 26 27 26 27 26 27 26 27 26 27 26 27 26 27 26 27 26 27 26 27 26 27 22 4 5 
3 47 48 44 4 4 4 4 4 4 4 4 4 4 4 4 4 4 4 4 4 4 4 4 4 4 4 4 4 4 4 4 4 4 4 4 4 4 4 4 4 4 4 4 4 4 4 4 4 4 4 4 4 4 4 4 4 4 4 4 4 4 4 4 4 4 4 4 4 5 
3 47 48 44 4 4 4 4 4 4 4 4 4 4 4 4 4 4 4 4 4 4 4 4 4 4 4 4 4 4 4 4 4 4 4 4 4 4 4 4 4 4 4 4 4 4 4 4 4 4 4 4 4 4 4 4 4 4 4 4 4 4 4 4 4 4 4 4 4 5 
3 47 48 44 4 4 4 4 4 4 4 4 4 4 4 4 4 4 4 4 4 4 4 4 4 4 4 4 4 4 4 4 4 4 4 4 4 4 4 4 4 4 4 4 4 4 4 4 4 4 4 4 4 4 4 4 4 4 4 4 4 4 4 4 4 4 4 4 4 5 
3 47 48 44 4 4 43 48 41 4 4 4 4 43 48 41 4 4 4 4 4 43 48 41 4 4 4 4 43 48 41 4 4 4 4 4 43 48 41 4 4 4 4 4 43 48 41 4 4 4 4 43 48 41 4 4 4 4 4 4 4 4 4 4 4 4 4 4 4 5 
3 47 48 63 4 4 47 48 44 4 4 4 4 47 48 44 4 4 4 4 4 47 48 44 4 4 4 4 47 48 44 4 4 4 4 4 47 48 44 4 4 4 4 4 47 48 44 4 4 4 4 47 48 44 45 45 45 45 45 45 45 45 45 45 4 4 4 4 4 5 
3 47 48 63 64 65 66 48 63 65 64 65 64 66 48 63 65 64 65 64 65 66 48 63 65 64 65 64 66 48 63 65 64 65 64 65 66 48 63 65 64 65 64 65 66 48 63 65 64 65 64 66 48 44 45 45 45 45 45 45 45 45 45 45 4 4 4 4 4 5 
3 47 48 48 48 48 48 48 48 48 48 48 48 48 48 48 48 48 48 48 48 48 48 48 48 48 48 48 48 48 48 48 48 48 48 48 48 48 48 48 48 48 48 48 48 48 48 48 48 48 48 48 48 44 45 45 45 45 45 45 45 45 45 45 4 4 4 4 4 5 
3 47 48 25 26 27 26 27 26 27 26 27 26 27 26 27 26 27 26 27 26 27 26 27 26 27 26 27 26 27 26 27 26 27 26 27 26 27 26 27 26 27 26 27 26 27 26 27 26 27 26 27 26 22 4 4 4 4 4 4 4 4 4 4 4 4 4 4 4 5 
3 47 48 44 4 4 4 4 4 4 4 4 4 4 4 4 4 4 4 4 4 4 4 4 4 4 4 4 4 4 4 4 4 4 4 4 4 4 4 4 4 4 4 4 4 4 4 4 4 4 4 4 4 4 4 4 4 4 4 4 4 4 4 4 4 4 4 4 4 5 
3 47 48 44 4 4 4 4 4 4 4 4 4 4 4 4 4 4 4 4 4 4 4 4 4 4 4 4 4 4 4 4 4 4 4 4 4 4 4 4 4 4 4 4 4 4 4 4 4 4 4 4 4 4 4 4 4 4 4 4 4 4 4 4 4 4 4 4 4 5 
3 47 48 44 4 4 4 48 4 4 4 4 4 4 4 4 4 4 4 4 4 4 48 4 4 4 4 4 4 48 4 4 4 4 4 4 4 48 4 4 4 4 4 4 4 4 4 4 4 4 4 4 4 4 4 4 4 4 4 4 4 4 4 4 4 4 4 4 4 5 
3 47 48 63 4 4 43 48 41 4 4 4 4 43 48 41 4 4 4 4 4 43 48 41 4 4 4 4 43 48 41 4 4 4 4 4 43 48 41 4 4 4 4 4 4 4 4 4 4 4 4 4 4 4 4 4 4 4 4 4 4 4 4 4 4 4 4 4 4 5 
3 47 48 44 4 4 47 48 44 4 4 4 4 47 48 44 4 4 4 4 4 47 48 44 4 4 4 4 47 48 44 4 4 4 4 4 47 48 44 4 4 4 4 4 4 4 4 4 4 4 4 4 4 4 4 4 4 4 4 4 4 4 4 4 4 4 4 4 4 5 
3 47 48 63 64 65 66 48 63 65 64 65 64 66 48 63 65 64 65 64 65 66 48 63 65 64 65 64 66 48 63 65 64 65 64 65 66 48 44 4 4 4 4 4 4 4 4 4 4 4 4 4 4 4 4 4 4 4 4 4 4 4 4 4 4 4 4 4 4 5 
3 47 48 48 48 48 48 48 48 48 48 48 48 48 48 48 48 48 48 48 48 48 48 48 48 48 48 48 48 48 48 48 48 48 48 48 48 48 44 4 4 4 4 4 4 4 4 4 4 4 4 4 4 4 4 4 4 4 4 4 4 4 4 4 4 4 4 4 4 5 
3 47 48 25 26 27 26 27 26 27 26 27 26 27 26 27 26 27 26 27 26 27 26 27 26 27 26 27 26 27 26 27 26 27 26 27 26 27 22 4 4 4 4 4 4 4 4 4 4 4 4 4 4 4 4 4 4 4 4 4 4 4 4 4 4 4 4 4 4 5 
3 47 48 44 4 4 4 4 4 4 4 4 4 4 4 4 4 4 4 4 4 4 4 4 4 4 4 4 4 4 4 4 4 4 4 4 4 4 4 4 4 4 4 4 4 4 4 4 4 4 4 4 4 4 4 4 4 4 4 4 4 4 4 4 4 4 4 4 4 5 
3 47 48 44 4 4 4 4 4 4 4 4 4 4 4 4 4 4 4 4 4 4 4 4 4 4 4 4 4 4 4 4 4 4 4 4 4 4 4 4 4 4 4 4 4 4 4 4 4 4 4 4 4 4 4 4 4 4 4 4 4 4 4 4 4 4 4 4 4 5 
3 47 48 44 4 4 4 4 4 4 4 4 4 4 4 4 4 4 4 4 4 4 4 4 4 4 4 4 4 4 4 4 4 4 4 4 4 4 4 4 4 4 4 4 4 4 4 4 4 4 4 4 4 4 4 4 4 4 4 4 4 4 4 4 4 4 4 4 4 5 
3 47 48 44 4 4 43 48 41 4 4 4 4 43 48 41 4 4 4 4 4 43 48 41 4 4 4 4 43 48 41 4 4 4 4 4 4 4 4 4 4 4 4 4 4 4 4 4 4 4 4 4 4 4 4 4 4 4 4 4 4 4 4 4 4 4 4 4 4 40 
3 47 48 44 4 4 47 48 44 4 4 4 4 47 48 44 4 4 4 4 4 47 48 44 4 4 4 4 47 48 44 4 4 4 4 4 4 4 4 4 4 4 4 4 4 4 4 4 4 4 4 4 4 4 4 4 4 4 4 4 4 4 4 4 4 4 4 4 40 122 
3 47 48 63 64 65 66 48 63 65 64 65 64 66 48 63 65 64 65 64 65 66 48 63 65 64 65 64 66 48 44 4 4 4 4 4 4 4 4 4 4 4 4 4 4 4 4 4 4 4 4 4 4 4 4 4 4 4 4 4 4 4 4 4 4 4 40 12 122 123 
3 47 48 48 48 48 48 48 48 48 48 48 48 48 48 48 48 48 48 48 48 48 48 48 48 48 48 48 48 48 44 4 4 4 4 4 4 4 4 4 4 4 4 4 4 4 4 4 4 4 4 4 4 4 4 4 4 4 4 4 4 4 4 4 4 40 122 123 123 123 
3 47 48 25 26 27 26 27 26 27 26 27 26 27 26 27 26 27 26 27 26 27 26 27 26 27 26 27 26 27 22 4 4 4 4 4 4 4 4 4 4 4 4 4 4 4 4 4 4 4 4 4 4 4 4 4 4 4 4 4 4 4 4 4 40 123 123 123 123 123 
3 47 48 44 4 4 4 4 4 4 4 4 4 4 4 4 4 4 4 4 4 4 4 4 4 4 4 4 4 4 4 4 4 4 4 4 4 4 4 4 4 4 4 4 4 4 4 4 4 4 4 4 4 4 4 4 4 4 4 4 4 4 40 12 122 79 50 50 50 50 
3 47 48 44 4 4 4 4 4 4 4 4 4 4 4 4 4 4 4 4 4 4 4 4 4 4 4 4 4 4 4 4 4 4 4 4 4 4 4 4 4 4 4 4 4 4 4 4 4 4 4 4 4 4 4 4 4 4 4 4 4 4 14 123 123 33 4 4 4 5 
3 47 48 44 4 4 4 4 4 4 4 4 4 4 48 4 4 4 4 4 4 4 4 4 4 4 4 4 4 4 4 4 4 4 4 4 4 4 4 4 4 4 4 4 4 4 4 4 4 4 4 4 4 4 4 4 4 4 4 4 4 4 14 123 123 33 4 4 4 5 
3 47 48 44 4 4 43 48 41 4 4 4 4 43 48 41 4 4 4 4 4 43 48 41 4 4 4 4 4 4 4 4 4 4 4 4 4 4 4 4 4 4 4 4 4 4 4 4 4 4 4 4 4 4 4 4 4 4 4 4 4 4 14 123 79 20 4 4 4 5 
3 47 48 44 4 4 47 48 44 4 4 4 4 47 48 44 4 4 4 4 4 47 48 44 4 4 4 4 4 4 4 4 4 4 4 4 4 4 4 4 4 4 4 4 4 4 4 4 4 4 4 4 4 4 4 4 4 4 4 4 4 4 14 123 33 4 4 4 4 5 
3 47 48 63 64 65 66 48 63 65 64 65 64 66 48 63 65 64 65 64 65 66 48 44 4 4 4 4 4 4 4 4 4 4 4 4 4 4 4 4 4 4 4 4 4 4 4 4 4 40 12 12 12 12 12 12 12 12 12 12 12 12 122 123 33 4 4 4 4 5 
3 47 48 48 48 48 48 48 48 48 48 48 48 48 48 48 48 48 48 48 48 48 48 44 4 4 4 4 4 4 4 4 4 4 4 4 4 4 4 4 4 4 4 4 4 4 4 4 40 122 123 123 123 123 123 123 123 123 123 123 123 123 123 123 33 4 4 4 4 5 
3 47 48 25 26 27 26 27 26 27 26 27 26 27 26 27 26 27 26 27 26 27 26 22 4 4 4 4 4 4 4 4 4 4 4 4 4 4 4 4 4 4 4 4 4 4 4 40 122 123 79 50 50 50 50 50 50 50 50 50 50 50 50 50 51 4 4 4 4 5 
3 47 48 44 4 4 4 4 4 4 4 4 4 4 4 4 4 4 4 4 4 4 4 4 4 4 4 4 4 4 4 4 4 4 4 4 4 4 4 4 4 4 4 4 4 4 4 14 123 123 33 4 4 4 4 4 4 4 4 4 4 4 4 4 4 4 4 4 4 5 
3 47 48 44 4 4 4 4 4 4 4 4 4 4 4 4 4 4 4 4 4 4 4 4 4 4 4 4 4 4 4 4 4 4 4 4 4 4 4 4 4 4 4 4 4 4 4 14 123 79 20 4 4 4 4 4 4 4 4 4 4 4 4 4 4 4 4 4 4 5 
3 47 48 44 4 4 4 4 4 4 4 4 4 4 4 4 4 4 4 4 4 4 4 4 4 4 4 4 4 4 4 4 4 4 4 4 4 4 4 4 4 4 4 4 4 4 4 14 123 33 4 4 4 4 4 4 4 4 4 4 4 4 4 4 4 4 4 4 4 5 
3 47 48 44 4 4 43 48 41 4 4 4 4 43 48 41 4 4 4 4 4 43 48 41 4 4 4 4 4 4 4 4 4 4 4 4 4 4 4 4 4 4 4 4 4 4 40 122 123 33 4 4 4 4 4 4 4 4 4 4 4 4 4 4 4 4 4 4 4 5 
3 47 48 44 4 4 47 48 44 4 4 4 4 47 48 44 4 4 4 4 4 47 48 44 4 4 4 4 4 4 4 4 4 4 4 4 4 4 4 4 4 4 4 4 4 4 14 123 79 20 4 4 4 4 4 4 4 4 4 4 4 4 4 4 4 4 4 4 4 5 
3 47 48 63 64 65 66 48 63 65 64 65 64 66 48 63 65 64 65 64 65 66 48 44 4 4 4 4 4 4 4 4 4 4 4 4 4 4 4 4 4 4 4 4 40 120 122 123 33 4 4 4 4 4 4 4 4 4 4 4 4 4 4 4 4 4 4 4 4 5 
3 47 48 48 48 48 48 48 48 48 48 48 48 48 48 48 48 48 48 48 48 48 48 44 4 4 4 4 4 4 4 4 4 4 4 4 4 4 4 4 4 4 4 4 14 123 123 79 20 4 4 4 4 4 4 4 4 4 4 4 4 4 4 4 4 4 4 4 4 5 
3 47 48 25 26 27 26 27 26 27 26 27 26 27 26 27 26 27 26 27 26 27 26 22 4 4 4 4 4 4 4 4 4 4 4 4 4 4 4 4 4 4 4 40 122 123 123 33 4 4 4 4 4 4 4 4 4 4 4 4 4 4 43 64 64 64 41 4 4 5 
3 47 48 44 4 4 4 4 4 4 4 4 4 4 4 4 4 4 4 4 4 4 4 4 4 4 4 4 4 4 4 4 4 4 4 4 4 4 4 4 4 4 4 103 123 123 79 20 4 4 4 4 4 4 4 4 4 4 4 4 4 4 62 48 48 48 44 4 4 5 
3 47 48 44 4 4 4 4 4 4 4 4 4 4 4 4 4 4 4 4 4 4 4 4 4 4 4 4 4 4 4 4 4 4 4 4 4 4 4 4 4 40 121 122 123 79 20 4 4 4 4 4 4 4 4 4 4 4 4 4 4 4 47 48 48 48 44 4 4 5 
4 47 48 44 4 4 4 4 4 4 4 4 4 4 4 4 4 4 4 4 4 4 4 4 4 4 4 4 4 4 4 4 4 4 4 4 4 4 4 4 40 122 123 123 79 20 4 4 4 4 4 4 4 4 4 4 4 4 47 48 44 156 47 48 48 48 44 4 4 5 
4 47 48 44 4 4 43 48 41 4 4 4 4 43 48 41 4 4 4 4 4 43 48 41 4 4 4 4 4 4 4 4 4 4 4 4 4 4 4 4 14 123 123 79 20 4 4 4 4 4 4 4 4 4 4 4 4 4 47 48 44 4 47 48 48 48 44 4 4 5 
4 47 48 44 4 4 47 48 44 4 4 4 4 47 48 44 4 4 4 4 4 47 48 44 4 4 4 4 4 4 4 4 4 4 4 4 4 4 4 4 14 123 123 33 4 4 4 4 4 4 4 4 4 4 4 4 4 4 47 48 44 4 47 48 48 48 44 4 4 5 
4 47 48 63 65 64 66 48 63 65 64 65 64 66 48 63 65 64 65 64 65 66 48 44 4 4 4 4 4 4 4 4 4 4 4 4 4 4 4 4 14 123 123 33 4 4 45 45 45 4 4 4 4 4 4 4 4 4 47 48 44 4 47 48 48 48 44 4 4 5 
4 47 48 48 48 48 48 48 48 48 48 48 48 48 48 48 48 48 48 48 48 48 48 44 4 4 4 4 4 4 4 4 4 4 4 4 4 4 4 40 122 123 123 33 4 4 45 45 4 4 4 4 4 4 4 4 4 4 47 48 44 4 24 26 26 26 22 4 4 5 
4 24 27 26 27 26 27 26 27 26 27 26 27 26 27 26 27 26 27 26 27 26 27 22 4 4 4 4 4 4 4 4 4 4 4 4 4 4 4 14 123 123 123 20 4 4 45 45 4 4 4 4 4 4 4 4 4 4 24 27 22 4 4 4 4 4 4 4 4 5 
102 102 4 4 4 4 4 4 4 4 4 4 4 4 4 4 4 4 4 4 4 4 4 4 4 4 4 4 4 4 4 4 4 4 4 4 4 4 4 14 123 123 33 101 4 4 4 4 4 4 4 4 4 4 4 4 4 4 4 4 4 4 4 4 4 4 4 4 4 5 
3 102 4 4 4 4 4 4 4 4 4 4 4 4 4 4 4 4 4 4 4 4 4 4 4 4 4 4 4 4 4 4 4 4 4 4 4 4 4 14 123 123 33 101 4 4 4 4 4 4 4 4 4 4 4 4 4 4 4 4 4 4 4 4 4 4 4 4 4 5 
39 100 100 100 36 36 36 36 36 36 36 36 36 36 36 36 36 36 36 36 36 36 36 36 36 36 36 36 36 36 36 36 36 36 36 36 36 36 100 14 123 123 33 101 36 36 36 36 36 36 36 36 36 36 36 36 36 36 36 36 36 36 36 36 36 36 4 4 4 40 
117 39 100 100 73 74 74 74 74 74 74 74 74 74 74 74 74 74 74 74 74 74 74 74 74 74 74 74 74 74 74 74 74 74 74 74 74 75 100 103 123 123 33 100 73 74 74 74 74 74 74 74 74 74 74 74 74 74 74 74 74 74 74 74 74 75 4 4 40 122 
123 98 100 100 92 93 93 93 93 93 93 93 93 93 93 93 93 93 93 93 93 93 93 93 93 93 93 93 93 93 93 93 93 93 93 93 93 94 100 103 123 123 33 100 92 93 93 93 93 93 93 93 93 93 93 93 93 93 93 93 93 93 93 93 93 94 4 40 122 123 
123 117 39 100 111 112 112 112 112 112 112 112 112 112 112 112 112 112 112 112 112 112 112 112 112 112 112 112 112 112 112 112 112 112 112 112 112 113 100 103 123 123 33 100 111 112 112 112 112 112 112 112 112 112 112 112 112 112 112 112 112 112 112 112 112 113 4 103 123 123 
123 123 117 121 130 131 131 131 131 131 131 131 131 131 131 131 131 131 131 131 131 131 131 131 131 131 131 131 131 131 131 131 131 131 131 131 131 132 121 122 123 123 117 118 130 131 131 131 131 131 131 131 131 131 131 131 131 131 131 131 131 131 131 131 131 132 118 122 123 123 
123 123 123 123 123 123 123 123 123 123 123 123 123 123 123 123 123 123 123 123 123 123 123 123 123 123 123 123 123 123 123 123 123 123 123 123 123 123 123 123 123 123 123 123 123 123 123 123 123 123 123 123 123 123 123 123 123 123 123 123 123 123 123 123 123 123 123 123 123 123 
123 123 123 123 123 123 123 123 123 123 123 123 123 123 123 123 123 123 123 123 123 123 123 123 123 123 123 123 123 123 123 123 123 123 123 123 123 123 123 123 123 123 123 123 123 123 123 123 123 123 123 123 123 123 123 123 123 123 123 123 123 123 123 123 123 123 123 123 123 123 
123 123 123 123 123 123 123 123 123 123 123 123 123 123 123 123 123 123 123 123 123 123 123 123 123 123 123 123 123 123 123 123 123 123 123 123 123 123 123 123 123 123 123 123 123 123 123 123 123 123 123 123 123 123 123 123 123 123 123 123 123 123 123 123 123 123 123 123 123 123 
123 123 123 123 123 123 123 123 123 123 123 123 123 123 123 123 123 123 123 123 123 123 123 123 123 123 123 123 123 123 123 123 123 123 123 123 123 123 123 123 123 123 123 123 123 123 123 123 123 123 123 123 123 123 123 123 123 123 123 123 123 123 123 123 123 123 123 123 123 123