294 295 296 297 298 351 352 353 354 355 6 6 6 6 6 6 6 6 6 191 177 356 357 358 359 360 6 381 6 6 6 6 6 6 6 264 265 6 6 6 6 176 632 633 634 635 636 6 6 6 6 6 235 233 235 156 -1 713 714 715 716 717 239 240 6 299 300 301 302 303 
313 314 315 316 317 370 371 372 373 374 239 240 0 784 785 786 787 788 233 231 171 375 376 377 378 379 -1 -1 351 352 353 354 355 -1 -1 283 284 178 194 194 194 195 651 652 653 654 655 6 -1 365 366 -1 233 306 307 232 232 732 733 734 735 736 258 259 -1 318 319 320 321 322 
332 333 334 335 336 389 390 391 392 393 258 259 0 803 804 805 806 807 233 231 152 394 395 396 397 398 0 0 370 371 372 373 374 268 -1 -1 -1 157 -1 -1 -1 -1 670 671 672 673 674 6 -1 384 385 -1 235 325 326 232 232 751 752 753 754 755 277 278 -1 337 338 339 340 341 
264 265 294 295 296 297 298 -1 237 238 277 278 0 822 823 824 825 826 233 231 190 191 191 177 -1 -1 604 605 389 390 391 392 393 0 0 -1 -1 157 -1 -1 -1 331 689 690 691 692 693 6 -1 367 368 -1 233 0 0 0 311 770 771 772 773 774 349 356 357 358 359 360 241 242 
283 284 313 314 315 316 317 -1 256 257 -1 -1 312 841 842 843 844 845 -1 -1 -1 -1 -1 152 269 -1 0 0 0 0 0 0 0 0 0 178 194 195 -1 -1 -1 -1 0 0 0 0 0 6 -1 -1 -1 -1 0 0 0 0 0 0 0 0 0 -1 -1 375 376 377 378 379 260 261 
239 240 332 333 334 335 336 -1 275 276 -1 -1 -1 -1 0 0 0 -1 -1 -1 -1 -1 -1 171 288 241 242 178 194 194 194 194 194 0 0 195 -1 -1 -1 -1 -1 -1 0 0 0 0 0 -1 -1 -1 -1 -1 0 0 0 0 0 0 0 0 -1 -1 -1 394 395 396 397 398 279 280 
258 259 -1 232 232 232 -1 -1 -1 -1 -1 -1 -1 -1 -1 -1 -1 -1 -1 -1 -1 -1 -1 152 249 260 261 157 -1 346 347 348 349 350 -1 239 240 -1 -1 -1 -1 -1 -1 -1 -1 -1 -1 -1 -1 -1 -1 -1 0 0 0 0 0 0 0 0 -1 -1 -1 245 246 -1 243 244 -1 6 
277 278 0 230 230 230 -1 -1 -1 -1 -1 -1 -1 -1 -1 -1 -1 -1 -1 -1 -1 264 265 171 -1 279 280 157 -1 349 365 366 -1 -1 -1 258 259 233 233 233 -1 -1 -1 -1 -1 -1 -1 -1 -1 -1 -1 -1 -1 -1 -1 -1 -1 -1 -1 -1 -1 -1 -1 264 265 -1 262 263 264 265 
344 345 0 233 233 233 -1 -1 -1 -1 -1 -1 -1 -1 -1 -1 -1 -1 -1 -1 -1 283 284 190 191 191 191 195 -1 409 410 411 412 413 -1 277 278 232 232 232 -1 -1 -1 -1 -1 -1 -1 -1 -1 -1 -1 -1 -1 11 12 12 12 12 13 -1 -1 264 265 283 284 -1 281 282 283 284 
363 364 637 638 639 -1 -1 -1 -1 -1 -1 -1 -1 0 0 0 -1 -1 -1 237 238 299 300 301 302 303 264 265 -1 428 429 430 431 432 -1 -1 230 230 230 264 265 -1 -1 -1 -1 -1 -1 -1 -1 0 0 11 12 122 123 123 123 123 117 13 -1 283 284 -1 -1 351 352 353 354 355 
365 366 656 657 658 235 -1 -1 -1 -1 -1 -1 -1 402 403 404 -1 264 265 256 257 318 319 320 321 322 283 284 -1 447 448 449 450 451 -1 -1 234 234 234 283 284 -1 -1 -1 -1 -1 -1 -1 -1 0 11 122 123 123 123 123 123 123 123 117 12 13 -1 264 265 370 371 372 373 374 
6 349 675 676 677 235 -1 -1 -1 -1 -1 -1 -1 421 422 423 -1 283 284 275 276 337 338 339 340 341 -1 -1 312 466 467 468 469 470 -1 -1 -1 -1 -1 -1 -1 -1 -1 -1 -1 -1 -1 -1 -1 11 122 123 123 123 123 123 123 123 123 123 123 117 13 283 284 389 390 391 392 393 
6 311 694 695 696 235 -1 -1 -1 -1 -1 -1 -1 440 441 442 -1 -1 239 240 1 557 558 559 560 -1 -1 -1 -1 -1 -1 -1 -1 -1 -1 -1 -1 -1 -1 -1 -1 -1 -1 -1 -1 -1 -1 -1 11 122 123 123 123 123 123 123 123 123 123 123 123 123 117 12 12 12 12 12 12 12 
6 -1 0 0 0 -1 -1 -1 -1 -1 -1 -1 330 459 460 461 264 265 258 259 -1 576 577 578 579 -1 -1 -1 -1 -1 -1 -1 -1 -1 -1 -1 -1 -1 -1 -1 -1 -1 -1 -1 -1 -1 -1 -1 30 123 123 123 123 123 123 123 123 123 123 123 123 123 123 123 123 123 123 123 123 123 
6 -1 0 0 0 -1 -1 -1 -1 -1 -1 -1 -1 0 0 0 283 284 277 278 -1 595 596 597 598 -1 -1 -1 -1 -1 -1 -1 -1 -1 -1 264 265 -1 -1 -1 -1 -1 -1 -1 -1 -1 -1 -1 49 84 123 123 123 123 123 123 123 123 123 123 123 123 123 79 50 50 50 50 50 50 
6 -1 -1 -1 -1 -1 -1 -1 -1 -1 -1 -1 -1 0 0 356 357 358 359 360 -1 614 615 616 617 -1 -1 -1 -1 -1 -1 243 244 241 242 283 284 709 710 711 712 -1 -1 356 357 358 359 360 -1 30 123 123 123 123 123 123 123 123 123 123 123 123 79 51 -1 -1 -1 -1 -1 6 
6 -1 -1 -1 -1 -1 -1 -1 -1 -1 -1 -1 346 347 348 375 376 377 378 379 243 244 -1 -1 -1 -1 -1 -1 -1 -1 -1 262 263 260 261 -1 -1 728 729 730 731 -1 -1 375 376 377 378 379 -1 49 84 123 123 123 123 123 123 123 123 123 123 79 51 -1 367 368 346 367 368 6 
6 -1 -1 -1 -1 -1 -1 -1 -1 -1 -1 -1 349 384 385 394 395 396 397 398 262 263 -1 -1 -1 -1 -1 -1 -1 -1 -1 281 282 279 280 -1 311 747 748 749 750 -1 -1 394 395 396 397 398 264 265 49 84 123 123 123 123 123 123 123 123 79 51 -1 -1 632 633 634 635 636 6 
6 289 290 290 290 291 -1 -1 -1 -1 -1 -1 -1 294 295 296 297 298 264 265 281 282 -1 -1 269 -1 -1 -1 -1 -1 237 238 351 352 353 354 355 766 767 768 769 -1 241 242 264 265 347 347 283 284 -1 49 50 50 84 123 123 79 50 50 51 -1 -1 -1 651 652 653 654 655 6 
6 310 233 104 234 310 -1 -1 -1 -1 -1 -1 -1 313 314 315 316 317 283 284 -1 -1 -1 -1 288 -1 -1 -1 -1 -1 256 257 370 371 372 373 374 230 0 230 -1 -1 260 261 283 284 365 366 -1 -1 -1 -1 -1 -1 103 123 123 98 -1 -1 -1 -1 -1 -1 670 671 672 673 674 6 
6 310 234 104 233 310 -1 -1 -1 -1 -1 0 -1 332 333 334 335 336 789 790 791 -1 -1 -1 -1 287 -1 -1 -1 -1 275 276 389 390 391 392 393 232 -1 232 -1 -1 279 280 -1 561 562 563 564 565 287 269 -1 -1 103 123 123 98 -1 232 231 233 230 312 689 690 691 692 693 6 
6 310 230 104 230 310 -1 -1 -1 -1 -1 232 232 -1 -1 -1 -1 235 808 809 810 235 -1 -1 -1 -1 0 -1 -1 -1 299 300 301 302 303 230 264 265 -1 230 -1 -1 -1 264 265 580 581 582 583 584 249 288 -1 -1 103 123 123 98 -1 231 344 345 233 -1 235 0 0 0 235 6 
6 252 328 -1 328 253 -1 -1 -1 -1 -1 232 247 248 -1 -1 -1 349 827 828 829 349 230 232 231 230 381 -1 -1 -1 318 319 320 321 322 230 283 284 -1 232 -1 -1 -1 283 284 599 600 601 602 603 -1 -1 -1 40 122 123 123 98 -1 233 363 364 231 -1 235 -1 -1 -1 235 6 
6 0 706 707 708 -1 -1 -1 -1 -1 -1 -1 266 267 233 -1 -1 331 846 847 848 0 231 0 0 0 0 -1 -1 -1 337 338 339 340 341 264 265 -1 -1 230 -1 -1 -1 -1 331 618 619 620 621 622 232 -1 -1 103 123 123 123 98 -1 230 233 231 232 -1 235 -1 -1 -1 235 6 
6 0 725 726 727 347 -1 -1 -1 -1 -1 -1 -1 233 233 -1 -1 0 0 0 0 0 232 -1 -1 -1 -1 0 6 0 -1 -1 -1 232 233 283 284 -1 -1 -1 -1 -1 -1 -1 384 385 0 0 0 349 232 -1 -1 103 123 123 123 98 -1 -1 -1 -1 -1 -1 -1 -1 -1 -1 0 6 
6 287 744 745 746 349 -1 -1 -1 -1 -1 -1 -1 -1 -1 -1 -1 -1 -1 -1 -1 -1 -1 -1 -1 -1 485 476 477 478 487 0 0 0 0 -1 -1 -1 -1 -1 -1 -1 -1 -1 -1 -1 -1 -1 -1 -1 -1 -1 -1 69 70 70 70 71 -1 -1 -1 -1 -1 -1 -1 -1 -1 -1 0 6 
6 312 763 764 765 -1 -1 -1 -1 -1 -1 -1 -1 -1 -1 -1 -1 -1 -1 -1 -1 -1 -1 -1 -1 -1 504 505 496 505 506 0 0 0 0 -1 -1 -1 -1 -1 -1 -1 -1 -1 -1 -1 -1 -1 -1 -1 -1 -1 -1 0 0 0 0 0 -1 -1 -1 -1 -1 -1 -1 299 300 301 0 6 
6 0 0 0 0 -1 -1 -1 -1 -1 -1 -1 -1 -1 -1 -1 -1 -1 -1 -1 -1 -1 -1 -1 -1 -1 513 514 515 516 517 254 0 0 0 -1 -1 -1 -1 -1 -1 -1 -1 -1 -1 -1 -1 -1 -1 -1 -1 -1 -1 0 0 0 0 0 -1 -1 -1 -1 -1 264 265 318 319 320 0 6 
356 357 358 359 360 -1 -1 -1 -1 -1 -1 -1 -1 -1 -1 -1 -1 264 265 -1 274 -1 0 -1 -1 0 532 533 534 535 536 273 0 0 264 265 293 -1 -1 -1 -1 -1 -1 -1 -1 -1 -1 -1 -1 -1 -1 -1 -1 107 108 108 108 109 -1 -1 -1 -1 -1 283 284 337 338 339 0 6 
375 376 377 378 379 0 -1 -1 -1 -1 -1 306 307 347 349 -1 -1 283 284 351 352 353 354 355 -1 -1 -1 0 0 0 -1 -1 -1 -1 283 284 264 265 -1 -1 -1 -1 -1 -1 -1 -1 -1 -1 -1 -1 -1 -1 -1 103 123 123 123 98 -1 -1 -1 -1 -1 -1 356 357 358 359 0 6 
394 395 396 397 398 0 -1 -1 -1 -1 -1 325 326 561 562 563 564 565 -1 370 371 372 373 374 239 240 -1 -1 -1 -1 -1 294 295 296 297 298 283 284 -1 -1 -1 -1 -1 -1 -1 -1 -1 -1 -1 -1 -1 -1 -1 103 123 123 123 98 -1 -1 239 240 264 265 375 376 377 378 0 6 
6 0 351 352 353 354 355 -1 -1 -1 -1 -1 -1 580 581 582 583 584 -1 389 390 391 392 393 258 259 -1 -1 -1 -1 -1 313 314 315 316 317 -1 -1 -1 -1 -1 -1 -1 -1 -1 -1 -1 -1 -1 -1 -1 -1 -1 103 123 123 123 98 -1 -1 258 259 283 284 394 395 396 397 0 6 
264 265 370 371 372 373 374 -1 -1 -1 -1 -1 -1 599 600 601 602 603 237 238 243 244 264 265 277 278 -1 643 644 645 -1 332 333 334 335 336 -1 -1 -1 -1 -1 -1 -1 -1 -1 -1 -1 -1 -1 -1 -1 -1 40 122 123 123 79 20 -1 -1 277 278 351 352 353 354 355 -1 0 6 
283 284 389 390 391 392 393 -1 -1 -1 -1 -1 331 618 619 620 621 622 256 257 262 263 283 284 287 241 242 662 663 664 -1 -1 -1 -1 239 240 -1 -1 -1 -1 -1 -1 -1 -1 -1 -1 -1 -1 -1 -1 -1 40 122 123 123 123 98 -1 239 240 264 265 370 371 372 373 374 264 0 6 
299 300 301 302 303 -1 -1 -1 -1 -1 -1 -1 -1 -1 235 0 235 -1 275 276 281 282 -1 -1 -1 260 261 264 265 -1 -1 -1 -1 -1 258 259 -1 -1 -1 -1 -1 -1 -1 -1 -1 -1 -1 -1 -1 -1 -1 103 123 123 123 123 98 -1 258 259 283 284 389 390 391 392 393 283 0 6 
318 319 320 321 322 -1 -1 -1 -1 -1 -1 -1 -1 -1 235 0 235 0 -1 356 357 358 359 360 -1 279 280 283 284 -1 643 644 645 -1 277 278 -1 -1 -1 -1 -1 -1 -1 -1 -1 -1 -1 -1 -1 -1 -1 103 123 123 123 123 98 -1 277 278 0 402 403 404 -1 -1 -1 -1 -1 6 
337 338 339 340 341 239 240 -1 -1 -1 -1 -1 -1 -1 235 0 235 0 -1 375 376 377 378 379 -1 -1 264 265 -1 -1 662 663 664 -1 789 790 791 -1 -1 -1 -1 557 558 559 560 -1 -1 -1 -1 -1 -1 103 123 123 123 123 98 -1 0 241 242 421 422 423 0 289 290 290 290 291 
6 -1 -1 241 242 258 259 -1 -1 -1 -1 -1 -1 -1 -1 -1 -1 264 265 394 395 396 397 398 -1 -1 283 284 -1 356 357 358 359 360 808 809 810 233 233 -1 235 576 577 578 579 235 -1 -1 -1 -1 -1 103 123 123 123 123 98 -1 348 260 261 440 441 442 0 308 232 232 232 310 
230 230 -1 260 261 277 278 -1 -1 -1 -1 -1 -1 -1 -1 -1 -1 283 284 -1 -1 -1 -1 -1 -1 -1 -1 241 242 375 376 377 378 379 827 828 829 233 233 -1 235 595 596 597 598 235 -1 -1 -1 -1 -1 103 123 123 123 123 98 -1 347 279 280 459 460 461 0 308 232 232 232 310 
230 230 -1 279 280 -1 -1 -1 -1 -1 -1 -1 -1 -1 -1 -1 -1 -1 -1 -1 -1 -1 -1 -1 -1 -1 -1 260 261 394 395 396 397 398 846 847 848 233 233 -1 311 614 615 616 617 -1 -1 -1 -1 -1 -1 103 123 123 123 123 98 234 235 234 312 0 0 0 0 308 235 235 235 310 
230 405 406 407 408 -1 -1 -1 -1 -1 -1 289 290 290 290 290 290 290 290 291 -1 -1 269 -1 -1 -1 -1 279 280 -1 351 352 353 354 355 0 0 -1 -1 -1 -1 0 0 0 -1 -1 -1 -1 -1 -1 -1 103 123 123 123 123 98 235 11 12 13 -1 -1 -1 0 308 233 233 233 310 
6 424 425 426 427 347 -1 -1 -1 -1 -1 308 367 368 348 0 349 365 366 310 -1 -1 288 -1 233 232 230 -1 264 265 370 371 372 373 374 0 0 -1 -1 -1 -1 -1 -1 -1 -1 -1 -1 -1 -1 -1 -1 103 123 123 123 123 98 234 30 31 32 -1 -1 -1 0 308 287 287 287 310 
330 443 444 445 446 348 -1 -1 -1 -1 -1 308 367 368 346 0 346 365 366 310 -1 -1 -1 11 12 13 232 -1 283 284 389 390 391 392 393 0 0 -1 -1 -1 -1 -1 -1 -1 -1 -1 -1 -1 -1 -1 -1 21 84 123 123 123 98 235 49 50 51 0 0 0 0 308 230 230 230 310 
6 462 463 464 465 -1 -1 -1 -1 -1 -1 308 367 368 347 0 348 365 366 310 -1 -1 -1 30 31 32 233 -1 -1 264 265 356 357 358 359 360 264 265 -1 348 346 347 348 349 -1 -1 -1 -1 -1 -1 -1 -1 103 123 123 123 98 -1 -1 0 0 0 0 0 0 327 328 -1 328 253 
6 0 0 0 0 -1 -1 -1 -1 -1 -1 308 367 368 349 -1 347 365 366 310 -1 -1 -1 49 50 51 287 -1 -1 283 284 375 376 377 378 379 283 284 -1 349 384 385 347 346 -1 -1 -1 -1 -1 -1 -1 -1 103 123 123 123 98 -1 -1 0 0 0 0 0 0 0 -1 -1 -1 6 
6 6 264 265 243 244 -1 -1 -1 -1 -1 327 -1 784 785 786 787 788 -1 329 -1 -1 -1 -1 -1 -1 409 410 411 412 413 394 395 396 397 398 -1 -1 -1 784 785 786 787 788 -1 -1 -1 -1 -1 -1 -1 -1 103 123 123 123 98 -1 -1 0 0 0 0 384 385 709 710 711 712 269 
118 39 283 284 262 263 -1 -1 -1 -1 -1 -1 -1 803 804 805 806 807 -1 -1 -1 -1 -1 -1 -1 -1 428 429 430 431 432 -1 299 300 301 302 303 -1 230 803 804 805 806 807 230 -1 -1 -1 -1 -1 -1 -1 103 123 123 123 98 -1 -1 0 0 0 0 365 366 728 729 730 731 288 
123 117 39 -1 281 282 -1 -1 -1 -1 -1 0 235 822 823 824 825 826 235 0 -1 -1 -1 -1 -1 -1 447 448 449 450 451 -1 318 319 320 321 322 -1 230 822 823 824 825 826 230 -1 -1 -1 -1 -1 -1 -1 103 123 123 123 117 39 -1 0 0 0 0 347 235 747 748 749 750 235 
123 123 98 356 357 358 359 360 -1 -1 -1 -1 312 841 842 843 844 845 0 -1 -1 -1 -1 -1 -1 311 466 467 468 469 470 -1 337 338 339 340 341 -1 331 841 842 843 844 845 -1 -1 -1 -1 -1 -1 -1 -1 21 84 123 123 123 117 39 0 0 0 0 381 235 766 767 768 769 235 
123 123 98 375 376 377 378 379 -1 -1 -1 -1 -1 -1 0 0 0 -1 0 -1 -1 -1 -1 -1 -1 -1 -1 0 0 0 0 -1 -1 -1 -1 -1 -1 -1 -1 -1 0 0 0 -1 -1 -1 -1 -1 -1 -1 0 0 0 69 70 70 70 70 71 0 0 0 0 0 330 0 0 0 264 265 
123 123 98 394 395 396 397 398 -1 -1 -1 -1 -1 -1 -1 -1 -1 0 -1 -1 -1 -1 -1 -1 -1 -1 -1 -1 -1 -1 -1 -1 -1 -1 -1 -1 -1 -1 -1 -1 -1 -1 -1 -1 -1 -1 -1 -1 -1 0 0 0 0 0 0 0 0 0 0 0 0 0 0 0 0 0 -1 -1 283 284 
123 123 117 39 -1 -1 -1 264 265 -1 -1 -1 -1 -1 -1 -1 -1 0 -1 -1 -1 -1 -1 -1 -1 -1 -1 -1 -1 -1 -1 -1 -1 -1 -1 -1 -1 -1 -1 -1 -1 -1 -1 -1 -1 -1 -1 -1 -1 0 0 0 0 0 0 0 0 0 0 0 0 0 0 241 242 351 352 353 354 355 
123 123 123 123 39 239 240 283 284 -1 -1 -1 -1 -1 -1 -1 0 0 -1 -1 -1 -1 -1 -1 -1 -1 -1 -1 -1 -1 -1 -1 -1 -1 0 0 -1 -1 637 638 639 -1 -1 -1 -1 713 714 715 716 717 -1 -1 0 107 108 108 108 108 109 -1 -1 -1 -1 260 261 370 371 372 373 374 
123 123 123 123 98 258 259 243 244 -1 -1 -1 -1 -1 -1 -1 0 -1 -1 -1 -1 -1 -1 -1 -1 -1 -1 -1 -1 -1 -1 -1 -1 -1 -1 -1 347 348 656 657 658 230 -1 -1 -1 732 733 734 735 736 239 240 -1 103 123 123 123 123 98 -1 -1 -1 -1 279 280 389 390 391 392 393 
123 123 123 123 98 277 278 262 263 -1 -1 -1 -1 -1 -1 -1 0 -1 -1 -1 -1 -1 -1 -1 -1 -1 -1 -1 -1 -1 -1 -1 -1 -1 -1 -1 -1 330 675 676 677 230 -1 -1 312 751 752 753 754 755 258 259 -1 103 123 123 123 123 98 -1 -1 -1 -1 -1 264 265 -1 6 6 6 
123 123 123 123 98 -1 -1 281 282 -1 -1 -1 -1 -1 -1 0 -1 -1 -1 -1 -1 -1 -1 -1 -1 -1 -1 -1 -1 -1 -1 -1 -1 -1 -1 -1 -1 -1 694 695 696 -1 -1 -1 0 770 771 772 773 774 277 278 -1 103 123 123 123 123 98 -1 -1 -1 243 244 283 284 6 40 118 118 
123 123 123 123 98 6 6 -1 -1 -1 -1 -1 -1 -1 -1 0 -1 -1 -1 -1 -1 -1 -1 -1 -1 -1 -1 -1 -1 -1 -1 -1 -1 -1 -1 -1 -1 -1 0 0 0 -1 -1 -1 -1 -1 -1 -1 -1 -1 264 265 6 103 123 123 123 123 98 -1 -1 -1 262 263 -1 6 40 122 123 123 
123 123 123 123 117 118 39 6 -1 -1 -1 -1 -1 -1 0 0 -1 -1 -1 -1 -1 -1 -1 -1 -1 -1 -1 -1 -1 -1 -1 -1 -1 -1 -1 -1 -1 -1 -1 -1 -1 -1 -1 -1 -1 -1 -1 -1 -1 -1 283 284 40 122 123 123 123 123 98 -1 -1 -1 281 282 6 40 122 123 123 123 
123 123 123 123 123 123 98 6 6 6 6 6 6 6 6 6 6 6 6 6 6 6 6 6 6 6 6 6 6 6 6 6 6 6 6 6 6 6 6 6 6 6 6 6 6 6 6 6 6 6 6 6 103 123 123 123 123 123 98 6 6 6 6 40 120 122 123 123 123 123 
123 123 123 123 123 123 117 118 130 131 131 131 131 131 131 131 131 131 131 131 131 131 131 131 131 131 131 131 131 131 131 131 131 131 131 131 131 131 131 131 131 131 131 131 131 131 131 131 131 132 119 121 122 123 123 123 123 123 117 118 119 120 121 122 123 123 123 123 123 123 
123 123 123 123 123 123 123 123 123 123 123 123 123 123 123 123 123 123 123 123 123 123 123 123 123 123 123 123 123 123 123 123 123 123 123 123 123 123 123 123 123 123 123 123 123 123 123 123 123 123 123 123 123 123 123 123 123 123 123 123 123 123 123 123 123 123 123 123 123 123 
123 123 123 123 123 123 123 123 123 123 123 123 123 123 123 123 123 123 123 123 123 123 123 123 123 123 123 123 123 123 123 123 123 123 123 123 123 123 123 123 123 123 123 123 123 123 123 123 123 123 123 123 123 123 123 123 123 123 123 123 123 123 123 123 123 123 123 123 123 123 
123 123 123 123 123 123 123 123 123 123 123 123 123 123 123 123 123 123 123 123 123 123 123 123 123 123 123 123 123 123 123 123 123 123 123 123 123 123 123 123 123 123 123 123 123 123 123 123 123 123 123 123 123 123 123 123 123 123 123 123 123 123 123 123 123 123 123 123 123 123 
123 123 123 123 123 123 123 123 123 123 123 123 123 123 123 123 123 123 123 123 123 123 123 123 123 123 123 123 123 123 123 123 123 123 123 123 123 123 123 123 123 123 123 123 123 123 123 123 123 123 123 123 123 123 123 123 123 123 123 123 123 123 123 123 123 123 123 123 123 123 
123 123 123 123 123 123 123 123 123 123 123 123 123 123 123 123 123 123 123 123 123 123 123 123 123 123 123 123 123 123 123 123 123 123 123 123 123 123 123 123 123 123 123 123 123 123 123 123 123 123 123 123 123 123 123 123 123 123 123 123 123 123 123 123 123 123 123 123 123 123 
123 123 123 123 123 123 123 123 123 123 123 123 123 123 123 123 123 123 123 123 123 123 123 123 123 123 123 123 123 123 123 123 123 123 123 123 123 123 123 123 123 123 123 123 123 123 123 123 123 123 123 123 123 123 123 123 123 123 123 123 123 123 123 123 123 123 123 123 123 123 
123 123 123 123 123 123 123 123 123 123 123 123 123 123 123 123 123 123 123 123 123 123 123 123 123 123 123 123 123 123 123 123 123 123 123 123 123 123 123 123 123 123 123 123 123 123 123 123 123 123 123 123 123 123 123 123 123 123 123 123 123 123 123 123 123 123 123 123 123 123 
123 123 123 123 123 123 123 123 123 123 123 123 123 123 123 123 123 123 123 123 123 123 123 123 123 123 123 123 123 123 123 123 123 123 123 123 123 123 123 123 123 123 123 123 123 123 123 123 123 123 123 123 123 123 123 123 123 123 123 123 123 123 123 123 123 123 123 123 123 123 
123 123 123 123 123 123 123 123 123 123 123 123 123 123 123 123 123 123 123 123 123 123 123 123 123 123 123 123 123 123 123 123 123 123 123 123 123 123 123 123 123 123 123 123 123 123 123 123 123 123 123 123 123 123 123 123 123 123 123 123 123 123 123 123 123 123 123 123 123 123 
123 123 123 123 123 123 123 123 123 123 123 123 123 123 123 123 123 123 123 123 123 123 123 123 123 123 123 123 123 123 123 123 123 123 123 123 123 123 123 123 123 123 123 123 123 123 123 123 123 123 123 123 123 123 123 123 123 123 123 123 123 123 123 123 123 123 123 123 123 123 
