180 181 182 183 184 185 186 187 180 181 182 183 184 185 186 187 180 181 182 183 184 185 186 187 180 181 182 183 184 185 186 187 180 181 182 183 184 185 186 187 180 181 182 183 184 185 186 187 180 181 182 183 184 185 186 187 180 181 182 183 184 185 186 187 180 181 182 183 184 185 
199 200 201 202 203 204 205 206 199 200 201 202 203 204 205 206 199 200 201 202 203 204 205 206 199 200 201 202 203 204 205 206 199 200 201 202 203 204 205 206 199 200 201 202 203 204 205 206 199 200 201 202 203 204 205 206 199 200 201 202 203 204 205 206 199 200 201 202 203 204 
218 219 220 221 222 223 224 225 218 219 220 221 222 223 224 225 218 219 220 221 222 223 224 225 218 219 220 221 222 223 224 225 218 219 220 221 222 223 224 225 218 219 220 221 222 223 224 225 218 219 220 221 222 223 224 225 218 219 220 221 222 223 224 225 218 219 220 221 222 223 
-1 399 400 401 239 240 557 558 559 560 156 -1 784 785 786 787 788 237 238 -1 -1 485 486 487 243 244 156 627 628 629 630 631 -1 -1 -1 713 714 715 716 717 239 240 -1 409 410 411 412 413 -1 -1 -1 637 638 639 356 357 358 359 360 709 710 711 712 -1 -1 488 489 490 -1 -1 
290 418 419 420 258 259 576 577 578 579 290 290 803 804 805 806 807 256 257 290 290 504 505 506 262 263 290 646 647 648 649 650 290 290 290 732 733 734 735 736 258 259 290 428 429 430 431 432 290 290 290 656 657 658 375 376 377 378 379 728 729 730 731 290 290 507 508 509 290 290 
287 437 438 439 277 278 595 596 597 598 384 385 822 823 824 825 826 275 276 346 347 523 524 525 281 282 349 665 666 667 668 669 264 265 347 751 752 753 754 755 277 278 268 447 448 449 450 451 367 368 348 675 676 677 394 395 396 397 398 747 748 749 750 232 232 526 527 528 346 348 
232 456 457 458 268 230 614 615 616 617 346 347 841 842 843 844 845 604 287 -1 -1 542 543 544 268 249 -1 684 685 686 687 688 283 284 349 770 771 772 773 774 549 550 381 466 467 468 469 470 -1 349 -1 694 695 696 268 249 381 585 586 766 767 768 769 -1 249 545 546 547 264 265 
331 6 77 -1 -1 312 146 58 566 567 -1 -1 331 166 58 166 235 235 235 -1 311 -1 58 -1 232 232 232 331 -1 58 -1 287 234 234 234 311 -1 58 -1 230 568 569 347 330 -1 58 -1 231 231 231 311 -1 58 -1 235 235 235 235 331 -1 58 -1 230 230 312 -1 58 -1 283 284 
156 -1 0 0 0 0 0 0 0 0 0 0 0 0 0 0 0 0 0 0 0 0 0 0 0 0 0 0 0 0 0 0 0 -1 -1 -1 0 0 0 0 0 0 0 0 0 0 0 0 0 0 -1 -1 -1 -1 -1 -1 -1 -1 -1 -1 -1 -1 -1 -1 -1 -1 -1 -1 -1 156 
156 -1 0 0 0 0 0 0 0 0 0 0 0 0 0 0 0 0 0 0 0 0 0 0 0 0 0 0 0 0 0 0 0 0 0 0 0 0 0 0 0 0 0 0 0 0 0 0 0 0 0 0 0 0 0 0 0 0 0 0 0 -1 -1 -1 -1 -1 -1 -1 -1 156 
156 -1 0 0 -1 -1 -1 -1 -1 -1 -1 -1 -1 -1 -1 -1 -1 -1 -1 -1 -1 -1 -1 -1 -1 0 0 0 0 0 0 0 0 -1 -1 -1 -1 -1 -1 -1 -1 -1 -1 0 0 0 0 0 0 0 0 0 0 0 0 0 0 0 0 0 -1 351 352 353 354 355 351 352 353 354 
156 -1 0 -1 -1 0 405 406 407 408 239 240 561 562 563 564 565 -1 -1 0 -1 706 707 708 237 238 -1 480 481 482 483 484 -1 -1 -1 -1 557 558 559 560 -1 -1 -1 784 785 786 787 788 243 244 -1 402 403 404 -1 -1 -1 -1 306 307 -1 370 371 372 373 374 370 371 372 373 
156 -1 0 -1 271 290 424 425 426 427 258 259 580 581 582 583 584 290 290 290 290 725 726 727 256 257 290 499 500 501 502 503 290 290 290 290 576 577 578 579 290 290 290 803 804 805 806 807 262 263 290 421 422 423 290 291 -1 -1 325 326 -1 389 390 391 392 393 389 390 391 392 
156 0 -1 -1 365 366 443 444 445 446 277 278 599 600 601 602 603 230 230 230 230 744 745 746 275 276 381 518 519 520 521 522 346 347 348 233 595 596 597 598 230 604 605 822 823 824 825 826 281 282 249 440 441 442 268 310 -1 -1 -1 -1 294 295 296 297 298 -1 -1 -1 -1 156 
156 0 0 -1 -1 268 462 463 464 465 233 233 618 619 620 621 622 264 265 249 287 763 764 765 566 567 -1 537 538 539 540 541 384 385 349 233 614 615 616 617 268 249 -1 841 842 843 844 845 367 368 604 459 460 461 348 310 -1 -1 -1 -1 313 314 315 316 317 -1 -1 -1 -1 156 
156 -1 0 -1 -1 331 -1 58 -1 287 -1 249 311 -1 58 -1 268 283 284 -1 330 -1 58 -1 235 235 235 312 -1 58 -1 381 268 249 -1 331 -1 58 -1 235 235 235 235 311 -1 58 -1 230 365 366 330 -1 58 -1 349 -1 0 0 -1 -1 332 333 334 335 336 -1 -1 -1 -1 156 
156 -1 0 0 0 0 0 0 0 0 0 0 0 0 0 0 0 0 0 0 0 0 0 0 0 0 0 0 0 0 0 0 0 0 0 0 0 0 0 0 0 0 0 0 0 0 0 0 0 0 0 0 0 0 0 -1 0 -1 -1 -1 -1 249 -1 -1 -1 -1 -1 -1 269 156 
156 -1 0 0 0 0 0 0 0 0 0 0 -1 -1 -1 -1 -1 -1 -1 -1 -1 -1 -1 0 0 0 0 0 0 0 0 0 0 0 0 0 0 0 0 0 0 0 0 0 0 0 0 0 0 0 0 0 0 0 -1 0 0 -1 -1 -1 -1 -1 -1 -1 -1 -1 -1 -1 288 156 
156 -1 -1 0 0 0 0 0 0 0 0 0 0 0 0 0 0 0 0 0 0 0 0 0 0 0 0 0 0 0 0 0 0 0 0 0 0 0 0 0 0 0 0 0 0 0 0 0 0 356 357 358 359 360 -1 0 -1 269 -1 -1 -1 -1 -1 -1 -1 -1 -1 -1 249 156 
156 -1 -1 -1 237 238 789 790 791 -1 -1 -1 480 481 482 483 484 243 244 243 244 640 641 642 -1 -1 -1 713 714 715 716 717 -1 239 240 -1 402 403 404 -1 -1 -1 -1 -1 -1 -1 -1 -1 -1 375 376 377 378 379 -1 -1 -1 288 -1 -1 -1 -1 -1 -1 -1 -1 -1 -1 -1 156 
156 -1 -1 -1 256 257 808 809 810 290 290 290 499 500 501 502 503 262 263 262 263 659 660 661 290 290 290 732 733 734 735 736 290 258 259 290 421 422 423 290 291 -1 -1 306 307 -1 -1 -1 -1 394 395 396 397 398 -1 -1 -1 -1 -1 -1 -1 306 307 -1 -1 -1 -1 -1 -1 156 
156 -1 -1 -1 275 276 827 828 829 384 385 349 518 519 520 521 522 281 282 281 282 678 679 680 346 347 348 751 752 753 754 755 347 277 278 346 440 441 442 232 310 -1 -1 325 326 -1 -1 299 300 301 302 303 -1 -1 -1 -1 -1 -1 -1 -1 -1 325 326 -1 243 244 -1 -1 -1 156 
156 -1 -1 -1 268 232 846 847 848 -1 249 287 537 538 539 540 541 566 567 367 368 697 698 699 264 265 381 770 771 772 773 774 -1 -1 585 586 459 460 461 287 310 -1 -1 -1 -1 -1 249 318 319 320 321 322 -1 -1 -1 -1 -1 -1 -1 -1 -1 -1 -1 -1 262 263 -1 -1 -1 156 
156 -1 -1 -1 -1 311 -1 58 -1 235 235 235 331 -1 58 -1 234 234 234 234 312 -1 58 -1 283 284 -1 330 -1 58 -1 230 233 230 233 311 -1 58 -1 -1 -1 -1 -1 -1 -1 -1 -1 337 338 339 340 341 -1 -1 -1 -1 -1 -1 -1 -1 -1 -1 -1 -1 281 282 -1 -1 -1 156 
156 -1 -1 0 0 0 0 0 0 0 0 0 0 0 0 0 0 0 0 0 0 0 0 0 0 0 0 0 0 0 0 0 0 0 0 0 0 -1 -1 351 352 353 354 355 -1 -1 -1 -1 -1 -1 -1 -1 -1 -1 237 238 239 240 -1 -1 -1 -1 239 240 -1 -1 -1 -1 -1 156 
156 -1 0 0 0 0 0 0 0 0 0 0 0 0 0 0 0 0 0 0 0 0 0 0 0 0 0 0 0 0 0 0 0 0 0 0 0 0 0 370 371 372 373 374 -1 -1 -1 -1 -1 -1 -1 -1 -1 -1 256 257 258 259 -1 -1 -1 -1 258 259 -1 -1 -1 -1 -1 156 
156 -1 0 0 0 0 0 0 0 0 0 0 0 0 0 0 0 0 0 0 0 0 0 0 0 0 0 -1 0 0 0 0 0 0 0 0 0 0 0 389 390 391 392 393 -1 -1 -1 -1 249 268 268 268 268 249 275 276 277 278 -1 -1 -1 -1 277 278 237 238 -1 -1 -1 156 
156 -1 -1 -1 -1 632 633 634 635 636 237 238 162 709 710 711 712 162 162 162 409 410 411 412 413 162 -1 -1 554 555 556 -1 -1 -1 -1 -1 294 295 296 297 298 -1 -1 -1 -1 -1 -1 -1 11 12 12 12 12 12 12 12 13 -1 -1 -1 -1 -1 -1 -1 256 257 -1 -1 -1 156 
156 -1 -1 -1 271 651 652 653 654 655 256 257 290 728 729 730 731 290 290 290 428 429 430 431 432 290 290 290 573 574 575 290 291 -1 -1 -1 313 314 315 316 317 -1 -1 -1 -1 -1 -1 -1 30 31 31 31 31 31 31 31 32 -1 -1 -1 344 345 -1 -1 275 276 249 -1 -1 156 
156 -1 -1 -1 230 670 671 672 673 674 275 276 287 747 748 749 750 234 232 234 447 448 449 450 451 264 265 231 592 593 594 235 310 -1 -1 -1 332 333 334 335 336 -1 -1 -1 -1 269 -1 -1 30 31 31 31 31 31 31 31 32 -1 -1 -1 363 364 -1 -1 -1 -1 -1 -1 -1 156 
156 -1 -1 -1 230 689 690 691 692 693 365 366 -1 766 767 768 769 232 156 232 466 467 468 469 470 283 284 -1 611 612 613 348 310 -1 -1 -1 -1 -1 -1 306 307 -1 -1 -1 -1 288 -1 -1 30 31 31 31 31 31 31 31 32 -1 -1 -1 -1 -1 -1 -1 -1 -1 -1 -1 -1 40 
156 -1 -1 -1 604 330 -1 58 -1 268 384 385 311 -1 58 -1 235 235 235 235 331 -1 58 -1 268 268 268 312 -1 58 -1 0 -1 -1 -1 -1 -1 -1 -1 325 326 -1 -1 -1 287 -1 -1 -1 49 50 50 50 50 50 50 50 51 -1 -1 -1 -1 -1 -1 -1 -1 -1 -1 -1 40 -1 
156 -1 -1 -1 -1 -1 -1 -1 -1 -1 -1 -1 -1 -1 -1 -1 -1 -1 -1 -1 -1 -1 -1 -1 -1 -1 -1 -1 -1 -1 -1 356 357 358 359 360 -1 -1 -1 -1 -1 -1 -1 -1 -1 -1 0 0 0 0 0 0 0 0 0 0 0 0 0 0 0 0 0 0 0 -1 40 12 -1 -1 
156 -1 -1 -1 -1 -1 -1 -1 -1 -1 -1 -1 -1 -1 -1 -1 -1 -1 -1 -1 -1 -1 -1 -1 -1 -1 -1 -1 -1 -1 -1 375 376 377 378 379 -1 -1 -1 -1 241 242 264 265 -1 -1 0 0 -1 -1 0 0 0 0 0 0 0 0 0 0 0 0 0 0 0 40 -1 -1 -1 -1 
156 -1 -1 -1 -1 -1 -1 -1 -1 -1 -1 -1 -1 -1 -1 -1 -1 -1 -1 -1 -1 -1 -1 -1 -1 -1 -1 -1 -1 -1 -1 394 395 396 397 398 -1 -1 -1 -1 260 261 283 284 -1 -1 0 0 -1 239 240 -1 -1 -1 -1 287 -1 269 -1 0 0 0 0 0 40 -1 -1 -1 -1 -1 
156 -1 -1 -1 -1 -1 402 403 404 241 242 237 238 637 638 639 -1 -1 -1 -1 784 785 786 787 788 -1 -1 -1 -1 -1 -1 -1 -1 -1 -1 -1 -1 -1 -1 -1 279 280 239 240 -1 0 0 0 -1 258 259 237 238 -1 -1 -1 249 288 0 0 0 -1 40 12 -1 -1 351 352 353 354 
156 -1 -1 -1 271 290 421 422 423 260 261 256 257 656 657 658 290 290 290 290 803 804 805 806 807 290 291 -1 -1 -1 -1 -1 -1 -1 -1 -1 -1 -1 -1 -1 -1 -1 258 259 -1 0 0 0 -1 277 278 256 257 -1 0 0 0 0 0 0 0 0 14 -1 -1 33 370 371 372 373 
156 -1 -1 -1 235 235 440 441 442 279 280 275 276 675 676 677 346 347 348 349 822 823 824 825 826 269 310 -1 -1 -1 -1 -1 -1 -1 -1 -1 -1 -1 -1 -1 -1 249 277 278 -1 0 -1 0 -1 -1 -1 275 276 0 0 0 0 0 0 0 0 0 14 -1 -1 33 389 390 391 392 
156 -1 -1 -1 348 349 459 460 461 234 -1 268 287 694 695 696 264 265 264 265 841 842 843 844 845 288 310 351 352 353 354 355 -1 -1 -1 -1 -1 -1 -1 -1 -1 -1 -1 -1 -1 0 0 0 0 0 0 0 0 0 0 0 0 0 0 0 0 -1 14 -1 -1 237 238 268 381 156 
156 -1 -1 -1 249 311 -1 58 -1 230 234 230 330 -1 58 -1 283 284 283 284 312 -1 58 -1 268 249 -1 370 371 372 373 374 -1 -1 -1 -1 269 -1 -1 -1 -1 -1 -1 -1 -1 0 0 166 -1 -1 -1 -1 -1 -1 -1 7 7 -1 -1 -1 -1 -1 14 -1 33 256 257 -1 -1 156 
156 -1 -1 -1 -1 -1 -1 -1 -1 -1 -1 -1 -1 -1 -1 -1 -1 -1 -1 -1 -1 -1 -1 -1 -1 -1 -1 389 390 391 392 393 -1 -1 -1 -1 288 -1 -1 -1 -1 -1 344 345 -1 -1 -1 -1 -1 40 12 12 12 -1 -1 12 12 12 12 12 12 12 -1 -1 33 275 276 -1 -1 156 
156 -1 -1 -1 -1 -1 -1 -1 -1 -1 -1 -1 -1 -1 -1 -1 -1 -1 -1 -1 -1 -1 -1 -1 -1 -1 -1 -1 -1 -1 -1 -1 -1 -1 -1 -1 -1 -1 -1 -1 -1 -1 363 364 -1 -1 -1 -1 40 -1 -1 -1 123 -1 -1 123 7 -1 -1 -1 -1 -1 -1 -1 33 269 511 512 -1 156 
156 -1 -1 -1 -1 -1 -1 -1 -1 -1 -1 -1 -1 -1 -1 -1 -1 -1 -1 -1 -1 -1 -1 -1 -1 -1 -1 -1 -1 -1 -1 -1 -1 -1 -1 -1 -1 -1 -1 -1 -1 -1 -1 -1 -1 -1 -1 40 -1 -1 -1 237 238 -1 -1 50 50 50 50 351 352 353 354 355 51 288 530 531 -1 156 
156 -1 -1 -1 -1 713 714 715 716 717 -1 -1 -1 405 406 407 408 237 238 -1 561 562 563 564 565 -1 -1 -1 -1 241 242 -1 -1 -1 -1 -1 -1 -1 -1 -1 -1 -1 -1 -1 -1 -1 -1 14 -1 -1 33 256 257 -1 -1 7 7 -1 -1 370 371 372 373 374 -1 -1 -1 -1 -1 156 
156 -1 -1 -1 271 732 733 734 735 736 290 290 290 424 425 426 427 256 257 290 580 581 582 583 584 290 291 -1 -1 260 261 -1 -1 -1 -1 -1 -1 -1 -1 -1 -1 -1 -1 -1 -1 -1 -1 14 -1 -1 20 275 276 0 -1 58 -1 293 -1 389 390 391 392 393 344 345 -1 -1 -1 156 
156 -1 -1 -1 347 751 752 753 754 755 233 233 287 443 444 445 446 275 276 348 599 600 601 602 603 235 310 -1 -1 279 280 264 265 -1 -1 -1 -1 -1 237 238 -1 -1 -1 -1 306 307 -1 14 -1 33 241 242 0 0 0 0 58 -1 -1 414 415 -1 -1 268 363 364 351 352 353 354 
156 -1 -1 -1 346 770 771 772 773 774 264 265 -1 462 463 464 465 365 366 347 618 619 620 621 622 235 310 -1 -1 -1 -1 283 284 0 -1 -1 -1 -1 256 257 -1 -1 -1 -1 325 326 40 -1 -1 33 260 261 0 0 0 0 0 -1 -1 433 434 0 0 0 0 0 370 371 372 373 
156 -1 -1 -1 -1 331 -1 58 -1 -1 283 284 311 -1 58 -1 381 -1 -1 249 330 -1 58 -1 381 -1 -1 -1 -1 -1 -1 -1 -1 -1 239 240 241 242 275 276 -1 -1 -1 -1 -1 -1 -1 -1 -1 20 279 280 0 0 58 0 0 -1 0 0 0 0 -1 0 0 0 389 390 391 392 
156 -1 -1 -1 -1 -1 -1 -1 -1 -1 -1 -1 -1 -1 -1 -1 -1 -1 -1 -1 -1 -1 -1 -1 -1 -1 -1 -1 -1 -1 -1 -1 -1 -1 258 259 260 261 -1 -1 -1 -1 -1 -1 40 118 -1 -1 239 240 381 0 0 0 -1 58 0 0 0 0 0 0 356 357 358 359 360 249 0 156 
156 -1 -1 -1 -1 -1 -1 -1 -1 -1 -1 -1 -1 -1 -1 -1 -1 -1 -1 -1 -1 -1 -1 -1 -1 -1 -1 -1 -1 -1 -1 -1 -1 -1 277 278 279 280 -1 -1 -1 0 1 1 14 1 1 1 258 259 0 0 0 0 0 0 254 0 0 0 0 0 375 376 377 378 379 0 0 156 
156 -1 -1 -1 -1 -1 -1 -1 -1 -1 -1 -1 -1 -1 -1 -1 -1 -1 -1 -1 -1 -1 -1 -1 -1 -1 -1 -1 -1 -1 -1 -1 -1 -1 -1 -1 -1 -1 -1 -1 -1 1 1 40 1 1 1 33 277 278 0 0 0 58 0 0 273 485 481 482 483 487 394 395 396 397 398 232 0 156 
156 -1 -1 -1 -1 632 633 634 635 636 -1 -1 -1 792 793 794 239 240 239 240 480 481 482 483 484 -1 -1 299 300 301 302 303 -1 -1 -1 -1 -1 -1 -1 -1 -1 1 1 14 1 1 241 242 585 586 -1 0 0 0 58 247 248 504 505 501 505 506 0 643 644 645 293 234 0 156 
156 -1 -1 -1 271 651 652 653 654 655 290 290 290 811 812 813 258 259 258 259 499 500 501 502 503 290 291 318 319 320 321 322 -1 -1 -1 -1 -1 -1 -1 -1 -1 40 118 -1 -1 -1 260 261 0 0 0 0 0 0 0 266 267 518 519 520 521 522 0 662 663 664 0 230 0 156 
156 -1 -1 -1 235 670 671 672 673 674 264 265 348 830 831 832 277 278 277 278 518 519 520 521 522 269 310 337 338 339 340 341 -1 -1 -1 -1 -1 -1 -1 -1 40 -1 -1 -1 237 238 279 280 249 0 0 0 0 0 0 0 249 537 538 539 540 541 0 643 644 645 0 232 0 156 
156 -1 -1 -1 230 689 690 691 692 693 283 284 -1 849 850 851 346 347 348 349 537 538 539 540 541 288 310 0 0 0 -1 -1 -1 -1 -1 269 -1 -1 -1 -1 14 -1 -1 -1 256 257 306 307 0 0 0 0 0 58 0 0 0 235 58 58 58 235 0 662 663 664 0 234 0 156 
156 -1 -1 -1 268 312 -1 96 -1 566 567 -1 331 -1 58 -1 268 249 -1 380 311 -1 96 -1 268 249 -1 0 0 0 0 0 -1 -1 -1 288 -1 -1 -1 -1 14 -1 -1 33 275 276 325 326 0 0 0 0 0 0 58 0 0 235 58 58 58 235 0 643 644 645 0 230 0 156 
156 -1 -1 -1 -1 -1 -1 -1 -1 -1 -1 0 0 0 0 0 0 0 0 0 0 0 -1 -1 -1 356 357 358 359 360 -1 0 0 -1 -1 -1 -1 -1 -1 -1 14 -1 -1 33 237 238 0 0 0 0 0 0 0 0 0 0 0 235 58 58 58 235 0 662 663 664 0 268 0 156 
156 -1 0 0 -1 -1 -1 -1 0 0 0 0 -1 -1 -1 -1 -1 -1 -1 -1 -1 0 -1 -1 -1 375 376 377 378 379 -1 -1 0 0 -1 -1 -1 -1 -1 40 -1 -1 -1 33 256 257 0 0 0 0 0 0 0 58 0 0 -1 235 58 58 58 235 0 0 0 0 0 249 0 156 
156 -1 -1 0 0 0 0 0 0 0 0 0 0 0 0 0 0 0 0 0 0 0 0 0 -1 394 395 396 397 398 -1 -1 -1 0 -1 -1 -1 -1 -1 14 -1 -1 -1 20 275 276 0 0 0 0 0 0 0 0 58 58 58 58 58 58 58 0 0 0 0 0 0 0 0 156 
156 -1 -1 -1 -1 0 0 0 0 0 0 0 0 0 0 0 -1 0 0 0 0 0 0 0 0 0 0 0 0 0 0 0 0 0 0 0 0 0 -1 14 -1 -1 33 0 0 0 0 0 268 0 0 0 0 0 58 58 58 58 58 58 58 0 0 0 0 0 0 0 0 156 
156 -1 -1 -1 -1 -1 -1 -1 -1 -1 -1 -1 -1 -1 0 0 0 0 0 0 0 0 0 -1 -1 0 0 0 0 0 0 0 0 0 0 0 -1 -1 -1 14 -1 -1 33 0 0 0 0 0 0 0 0 0 0 0 0 0 0 0 0 0 0 0 0 0 0 0 0 0 0 156 
39 -1 -1 -1 -1 -1 -1 -1 -1 -1 -1 -1 -1 -1 -1 -1 -1 -1 -1 -1 -1 -1 -1 -1 -1 -1 -1 -1 -1 -1 -1 -1 -1 -1 -1 -1 -1 -1 -1 14 -1 -1 33 0 0 0 0 0 0 0 0 0 0 0 0 0 0 0 0 0 0 0 0 0 0 0 0 0 0 40 
-1 39 -1 -1 -1 -1 -1 -1 -1 -1 -1 -1 -1 -1 -1 -1 -1 -1 -1 -1 -1 -1 -1 -1 -1 -1 -1 -1 -1 -1 -1 -1 -1 -1 -1 -1 -1 -1 -1 103 -1 -1 33 0 0 0 0 0 0 0 0 0 0 0 0 0 0 0 0 0 0 0 0 0 0 0 0 0 40 -1 
123 98 -1 -1 -1 -1 -1 -1 510 -1 -1 -1 -1 -1 454 493 -1 -1 -1 -1 -1 -1 -1 -1 -1 -1 -1 -1 -1 473 -1 -1 -1 474 493 -1 -1 -1 -1 103 -1 -1 33 0 0 454 455 0 0 0 0 0 0 493 474 0 0 0 0 0 0 492 0 0 493 0 0 40 -1 -1 
123 -1 39 -1 -1 -1 491 -1 -1 -1 -1 -1 -1 -1 473 474 -1 -1 -1 -1 -1 -1 -1 -1 -1 -1 -1 -1 -1 -1 492 -1 -1 -1 455 -1 -1 -1 -1 103 -1 -1 33 0 0 0 0 0 0 0 0 0 0 -1 0 -1 0 0 0 0 0 0 0 0 0 0 0 103 -1 -1 
123 123 -1 118 130 131 131 131 131 131 131 131 131 131 131 131 131 131 131 131 131 131 131 131 131 131 131 131 131 131 131 131 131 131 131 131 131 132 118 -1 -1 -1 -1 118 130 131 131 131 131 131 131 131 131 131 131 131 131 131 131 131 131 131 131 131 131 132 118 -1 -1 -1 
-1 -1 -1 -1 -1 -1 -1 -1 -1 -1 -1 -1 -1 -1 -1 -1 -1 -1 -1 -1 -1 -1 -1 -1 -1 -1 -1 -1 -1 -1 -1 -1 -1 -1 -1 -1 -1 -1 -1 -1 -1 -1 -1 -1 -1 -1 -1 -1 -1 -1 -1 -1 -1 -1 -1 -1 -1 -1 -1 -1 -1 -1 -1 -1 -1 -1 -1 -1 -1 -1 
-1 -1 -1 -1 -1 -1 -1 -1 -1 -1 -1 -1 -1 -1 -1 -1 -1 -1 -1 -1 -1 -1 -1 -1 -1 -1 -1 -1 -1 -1 -1 -1 -1 -1 -1 -1 -1 -1 -1 -1 -1 -1 -1 -1 -1 -1 -1 -1 -1 -1 -1 -1 -1 -1 -1 -1 -1 -1 -1 -1 -1 -1 -1 -1 -1 -1 -1 -1 -1 -1 
-1 -1 -1 -1 -1 -1 -1 -1 -1 -1 -1 -1 -1 -1 -1 -1 -1 -1 -1 -1 -1 -1 -1 -1 -1 -1 -1 -1 -1 -1 -1 -1 -1 -1 -1 -1 -1 -1 -1 -1 -1 -1 -1 -1 -1 -1 -1 -1 -1 -1 -1 -1 -1 -1 -1 -1 -1 -1 -1 -1 -1 -1 -1 -1 -1 -1 -1 -1 -1 -1 
-1 -1 -1 -1 -1 -1 -1 -1 -1 -1 -1 -1 -1 -1 -1 -1 -1 -1 -1 -1 -1 -1 -1 -1 -1 -1 -1 -1 -1 -1 -1 -1 -1 -1 -1 -1 -1 -1 -1 -1 -1 -1 -1 -1 -1 -1 -1 -1 -1 -1 -1 -1 -1 -1 -1 -1 -1 -1 -1 -1 -1 -1 -1 -1 -1 -1 -1 -1 -1 -1 

